1111111111111111111111111111111111
1E0000000000000C00000C001111000001
1010010100100000101001000000010101
1010010010101010001001000X00010101
1PC000000C00C00000000X000X00000XC1
1111111111111111111111111111111111