111111111111111
1E1001111000001
100C0000000X001
100X00XC0X00X01
110C0000X000001
100X00C00000P01
111111111111111